XXXXXXXXXXXXXXXXXXXXXXXXX
X   G XXXXXXXXXXXXXXXXXXX
X XXX XXXXXX     G     XX
X XXX XXXXXX XXXXXXXXX XX
X XXX XXXXXX XXXXXXXXX XX
X XXX XXXXXX XXXXXXXXX XX
X XXXTXXXXXX XXXXXXXXXGXX
X XXX XXXXXX XXXXXXXXX XX
X XXX XXXXXX XXXXXXXXX XX
X XXX XXXX  T  XXXXXXX XX
X X      X     XXXXXXX XX
X X      X     XXXXXXX XX
X X  G   X     XXXXXXX XX
X X      X G G  XXXXXX XX
X X    E X     XXXXXXX XX
X XXXXXXXXXXXXXXXXXXXX XX
X G              T XXX XX
XXXXXXXXXXXXXXXXXX XXX XX
XXXX      G        XXX XX
XXXX X             XXX XX
XXXX X             XXX XX
XXXX X        T    XXX XX
XXXX XXXXXXXXXXXXXXXXX XX
XXXX  G              T XX
XXXXXXXXXXXXXXXXXXXXXXXXX
