XXXXXXXXXXXXXXXXXXXXXXXXX
XX T         XXX     E XX
XX           XXX       XX
XX        G  XXX G     XX
XXXXX   XXXXXXXX       XX
XXXXX   XXXXXXXXXX    XXX
XXXXX   XXXXXXXXXX    XXX
XXXXX   XXXXXXXXXX    XXX
XX  T         XXXX    XXX
XX            XXXX    XXX
XX         G  XT        X
XXXX   XXXXXXXX       G X
XXXX   XXXXXX     XXXXXXX
XXXX   XXXXXX     XXXXXXX
XXXX   XXXXXXXXX       XX
XXX      T XXXXX       XX
XXX        XXX         XX
XXX        XXX         XX
XXX      G XXX         XX
XXXX    XXXXXX G       XX
XXXX    XXXXXXXXX   XXXXX
XXXX    XXXXXXXXX   XXXXX
XX                T XXXXX
XX G                XXXXX
XXXXXXXXXXXXXXXXXXXXXXXXX