XXXXXXXXXXXXXXXXXXXXXXXXX
XX        T       XXXXXXX
XX  G             XXE G X
XX  XXXXXXXXXXXX  XX    X
XX       GXXXXXX  XXT   X
XX  XXXX  XXXXXX  XX    X
XX        XXXXXX  XX    X
XXXXXXXXXXXXXXXX  XX    X
X                 XX    X
X   T       XXXXXXX   XXX
X           XXXXXXX   XXX
XXXX G XXXXXXXXXXXX   XXX
XXXX   XXXX G         XXX
XXXX   XXXXXXXXXXXX   XXX
X            GXXXXX   XXX
X     T       XXXXX   XXX
X G           XXXXX   XXX
XXXXXXXXXX    XXXXX   XXX
XXXXXXXXXX    XXXXX   XXX
XX   GXXXX    XXXXX   XXX
XX    XXXX    XXXXX   XXX
XX    XXXX    XXXXX   XXX
XX    XXXX          T XXX
XX T        G XXXXXXXXXXX
XXXXXXXXXXXXXXXXXXXXXXXXX