XXXXXXXXXXXXXXXXXXXXXXXXX
XXXXG                  XX
XXXX  X  XXXX G        XX
XXXX  X  XXXX          XX
XXXX  X  XXXX   T      XX
XXXX  X  XXXXXXXX  XXXXXX
XXXX  X  XXXXXXXX  XXXXXX
XXXX  X  XXXXXXX    XXXXX
XXXX TX  XXXXXXX  G XXXXX
XXXX  X  XXXXXXXXXXXXXXXX
XX                  G  XX
XX G                   XX
XXXXXXXXXXXXXXXXXX  XXXXX
XEXXXXXXXXXXXXXXXX  XXXXX
X XXXXXXXXXXXXXXXX  XXXXX
X           G   XX    TXX
X               XX  XX XX
X T             XX  XX XX
XXXXXXX     XXXXXX  XX XX
XXXXXXX     XXXXXX  XX XX
XXXXXXX     XXXXXX  XX XX
XXXXXXX     XXXXXX  XX XX
XXX G               XX XX
XXX           T     XXGXX
XXXXXXXXXXXXXXXXXXXXXXXXX