XXXXXXXXXXXXXXXXXXXXXXXXX
X G X        G     TXXE X
X   X   XXXXXXXXXXX XXX X
XX XXX XXXXXXXXXXXX XXX X
XX XXX XXXXXXXXXXXX XXX X
XX XXX XXXXXXXXXXXX XXX X
XX XXX XXX     XXXX XXX X
XX XXX XXX     XXXX XXX X
XX XXX XXX  G  XXXX XXX X
XX XXX XXXXX  XXXXX XXXGX
XX    T XXXXT XXXXX XXX X
XX      XXXX  XXXXX XXX X
XXXXXXXXXXXX  XXXXX XXX X
XXXXXXXXXXXX  XXXXX XXX X
XXXXXXXXXXXX  XXXXX XXX X
X G                 XXXTX
X XXXXXXXXXXXXXXXXXXXXX X
X XXXX            G     X
X XXXX  XXXXXXXXXXXXXXXXX
X XXXX  XXXXXXXXXXXXXXXXX
X XXXX  T             XXX
X XXXXXXXXXXXXXXXXXXX XXX
X                     XXX
X         G           XXX
XXXXXXXXXXXXXXXXXXXXXXXXX
