XXXXXXXXXXXXXXXXXXXXXXXXX
XXX  GXXXXXXXXXXXXXXXXXXX
XXX             GXXXXXXXX
XXT   XXXXXXXX XXXXXXXXXX
XXXX XXXXXXXXX XXXXXXXXXX
XXXX XXXXXXXXG XXXXXXXXXX
XXXX XXXXXXXXX   XXXXXXXX
XXXX XXXXXXXXX  TXXXXXXXX
XXXX XXXXXXXXX   XXXXXXXX
XXXX XXXXXXXXXX XXXXXXXXX
XXXX XXXXXXXXXXTXXXXXXXXX
XXXX XXXXXXXXX  XXXXXXXXX
XXXX XXXXXXXXX  XXXXXXXXX
XXXX XXXXXXXXX  XXXXXXXXX
XXXX XXXXXXXXXX XXXXXXXXX
XXXX XXXXXXXXXX XXXXXXXXX
XX  TXXXXXXXXXX  XXXXXXXX
XG   XXXXXXXXXX  XXXXXXXX
XX   XXXXXXXXXX  XXXXXXXX
XXXXXXXXXXXXXXX XXXXXXXXX
XXXXXXXXXXXXX   XXXXXXXXX
XXXXXXXXXXXXG  EXXXXXXXXX
XXXXXXXXXXXXX   XXXXXXXXX
XXXXXXXXXXXXXXXXXXXXXXXXX
XXXXXXXXXXXXXXXXXXXXXXXXX

