XXXXXXXXXXXXXXXXXXXXXXXXX
X G              XXXXXXXX
X    XXXXXXXXXX  XXXXXXXX
X    XXXXXXXXXX  XXXXXXXX
XXX  XXXXXXXXXX  XXXXXXXX
XXX  XXXXX        T   XXX
XXX  XXXXX            XXX
XXX  XXXXX G          XXX
XXX  XXXXXXXXX   XXXXXXXX
XXX  XXXXXXXXX   XXXXXXXX
X      G XXXXX   XXXXXXXX
X        XXXXXX   XXXXXXX
X    T   XXXXXXX   XXXXXX
XXXX  XXXXXXXXXXX   XXXXX
XXXX  XXXXXXXXXXXX  XXXXX
XXXX  XXXXXXXXXXXX  XXXXX
XXXX       XXXXXXX  XXXXX
XXXXXXXXX  XXXX G      XX
XXXXXXXXX  XXXX     T EXX
XXXXXXXXX  XXXXXXXXXXXXXX
XXXXXX G     T XXXXXXXXXX
XXXXXX         XXXXXXXXXX
XXXXXX         XXXXXXXXXX
XXXXXX         XXXXXXXXXX
XXXXXXXXXXXXXXXXXXXXXXXXX