XXXXXXXXXXXXXXXXXXXXXXXXX
XXXXXXXXXXXXXXXXXX G  EXX
XXXXXXXXXXXXXXXXXX    XXX
XXXXXXXXXXXXXXXXXX   XXXX
XXXG                 XXXX
XXX  XXXXXXXXXXXXXX TXXXX
XXX  XXX G           XXXX
XXX  XXXXXXXXXXXXXXXXXXXX
XXX TXXXXXXXXXXXXXXXXXXXX
XXX                     X
XXXXXXXXXXXXXXXXXXXXXX  X
XXXXXXXXX         GXXX  X
XX       T         XXX  X
X  XXXXXX          XXX  X
X XXXXXXX          XXX  X
X XXXXXXXXXXXXXXXXXXXX  X
X XXXXXX              G X
X XXXXXX    XXXXXXXXXXXXX
X XXXXXX    XXXXXXXXXXXXX
X XXXX        XXXXX G XXX
X XXXX        XXXXX   XXX
X XXXX        XXXXX   XXX
X  G          XXXXX   XXX
XXXXXXXXX   T         XXX                 
XXXXXXXXXXXXXXXXXXXXXXXXX