XXXXXXXXXXXXXXXXXXXXXXXXX
X    G       T        XXX
XT        EXXXXXX    GXXX
X XXXXXXXXXXXXXXXXX XXXXX
X X   T           X XXXXX
X X         G     X XXXXX
X X XXXXXXXXXXXXX X XXXXX
X X XXXXXXXXXXXXX   XXXXX
X X XXXXXXXXXXXXXXXXXXXXX
XGX XXXXXXT            XX
X X XXXXXX XX      G   XX
X X XXXXXX XX          XX
X X XXXXXX XXXXXXXXXXX XX
X X XXXXXX XXXXXXXXXXX XX
X X XXXXXX XXXXXXXXXXX XX
X X          G     XXX XX
X X  T             XXX XX
X XXXXXXXXXXXXXXXXXXXX XX
X XXXXXXXXXXX  G       XX
X XXXXXXXXXXX          XX
X XXXXXXXXXXX          XX
XGXXXXXXXXXXX          XX
X XXXXXXXXXXX          XX
X          T           XX
XXXXXXXXXXXXXXXXXXXXXXXXX
